++++++++++++++++++++++
+000+000++0++00000+000
+0+000+0000000+++0+0++
+0+0+00++00++++000+0++
+++0++++++0000+++0+00+
+0000000000++00++0000+
+++++0++++++000+++++0+
+00000+000+++++++00+0+
+0+++++++000000S0+000+
+0000000000000000+0+++
++++++++++++++++++0+++